NO textures/simonkraft/wet_sponge.xpm
SO textures/simonkraft/cyan_concrete.xpm
WE textures/simonkraft/soul_sand.xpm
EA textures/simonkraft/netherrack_02.xpm

F 164,169,20
C 153,204,255

11111
10001
10001
10S01
11111
